абсолютный: абсолютная
абстрагироваться: абстрагируемся
абстрактный: абстрактных
авг: авг
автоматически: автоматически
автор: автора, автор, авторов, автору, авторами, автором
авторитетный: авторитетной, авторитетных
агентство: агентство
адекватный: адекватное, адекватные
адрес: адресу, адреса, адрес
адресный: адресной
акаунт: акаунт
аккаунт: аккаунты, аккаунт
аккаунтаудалить: аккаунтаудалить
аккаунтудаление: аккаунтудаление
аккуатный: аккуатно
активно: активно
активность: активности, активность
активный: активный
акция: акции, акциях
александр: александр, александра
алексей: алексей
алфавитный: алфавитный
альтернативный: альтернативным
американский: американских, американские
аналогичный: аналогичной
анатолий: анатолий
англоязычный: англоязычного
анимировать: анимированный
анонимный: анонимного
анонс: анонсов, анонс
антон: антон
ап: ап
аргумент: аргументы
арифметический: арифметические
армия: армии
арсений: арсений
ассоциироваться: ассоциируется
атака: атаки
атакаджордж: атакаджордж
атаковать: атакуемого
аудио: аудио
аудиредактор: аудиредактор
аудитоия: аудитоий
аудитория: аудиторию, аудиторий, аудитории, аудитория
ашманов: ашманову
баг: баг
база: базе, базу
бакунов: бакунов
бал: бал
баландин: баландин
балл: баллы, балл, баллов
банально: банально
банальный: банальные
бангкок: бангкоке
баннер: баннеру, баннеры, баннеров, баннер
баннерный: баннерные
беглый: беглый
бегун: бегун, бегуном
беда: беда
безопасность: безопасности
безошибочный: безошибочной
беларусь: беларуси
бережно: бережно
бесконечный: бесконечной
бесплатный: бесплатный
бесполезно: бесполезно
бессмысленность: бессмысленности
бессмысленный: бессмысленных
бизнес: бизнес, бизнеса
битый: битую
благополучие: благополучие
благополучный: благополучных
блистать: блистал
блог: блогов, блога, блоги, блогах, блоге, блог
блоггинга: блоггинг
блогер: блоггеры, блоггерам, блоггеров
блогзаголовок: блогзаголовок
блогновое: блогновое
блогостратегия: блогостратегии
блогосфера: блогосферой, блогосфера
блокнотик: блокнотиков, блокнотика, блокнотик
боль: боли
больший: больший, большее, большим, большую
большинство: большинству
большой: большой
борьба: борьба
бот: бот, боты
бояться: бояться
брайан: брайан
брать: брать
браузер: браузера, браузерах, браузере
бренд: брендов, брендам, бренда
брендинг: брендинг
брендирование: брендировании
брендировать: брендировать, брендировали
бригада: бригаде
бродить: бродите
броситься: бросилось
будущее: будущем
будущий: будущих
буква: буква
буквально: буквально
буклет: буклет
бумер: бумеров
бурмистров: бурмистрова
буш: буш, бушу
бывать: бывают
бывший: бывший, бывшего
быстро: быстро
бэйбить: бэйби
вадим: вадим
важно: важно
важный: важнее, важны, важную
валериевич: валерьевича
вариант: вариант, вариантов
василий: василия
ваховский: ваховский
ваш: вашему, вашего, вашей
введение: введение
вверху: вверху
ввести: ввести, введя
ввид: ввиде
ввод: вводом
вводный: вводное
веб: веб
вебальт: вебальты
вебмастер: вебмастерам
вебстраница: вебстраницы
вебстраничка: вебстраничек
вебсёрфер: вебсерфер
ведомость: ведомостях
ведущий: ведущие
великий: великая
величина: величину
величко: величко
верно: верно
вернуться: вернуться
вероятно: вероятно
вероятность: вероятность
версия: версию
вес: вес
весело: весело
весомый: весомые
весь: всей
весьма: весьма
вещь: вещей, вещью, вещи, вещь
взаимотребленный: взаимотребленные
взамен: взамен
взгляд: взгляды, взглядов, взгляд
взрослеть: взрослеет
взрослый: взрослых, взрослый
взрыв: взрыв
вид: вид, виду, виде
видео: видео
видеоигра: видеоигры
видеосюжет: видеосюжет
видеть: вижу, видит, видим
видно: видно
википедия: википедию
виноватый: виновата
виртуальный: виртуальной
вирусный: вирусных, вирусный
включая: включая
включить: включен
вкратце: вкратце
владелец: владельцы, владельцев
владивосток: владивосток
владислав: владислава, владислав
влиять: влияет
вместе: вместе
вместо: вместо
внедрение: внедрение
внедряемость: внедряемость
внешний: внешние
внимание: внимание
внутренний: внутренняя
внутри: внутри
вобщий: вобщем
вовремя: вовремя
вовсе: вовсе
воздействие: воздействии
возможно: возможно
возможность: возможностей, возможности, возможность
возникать: возникает
возникнуть: возникла
войти: вошел
волгоград: волгоград
вообще: вообще
вообщий: вообщем
воплощение: воплощении
вопрос: вопроса, вопросов, вопрос, вопросах, вопросом, вопросу, вопросы
воспользоваться: воспользоваться
воспринимать: воспринимаю
восстановить: восстановить
восстановление: восстановление
восхищаться: восхищается
впервые: впервые
вполне: вполне
впрямую: впрямую
вражеский: вражеской
время: временем
вроде: вроде
всероссийский: всероссийской
всерьёз: всерьез
вспомнить: вспомнить
встреча: встречу
всякий: всякие
всяческий: всяческий
вторично: вторично
второй: вторую, вторых, вторые
вукс: вукс
вход: вход
выбирать: выбирать
выборка: выборку
выбрать: выбрал, выбрать, выбранного
вываливать: вываливает
вывод: выводом, выводы, вывод
выводить: выводить
выводиться: выводится
выглядеть: выглядеть, выглядит
выгодно: выгодно
выдавать: выдавать
выдача: выдачи
вызывать: вызывает
выиграть: выиграет
выкатить: выкатить
выкладка: выкладке
вылезать: вылезает, вылезают
выложить: выложил
выпад: выпады
выплачивать: выплачивая
выполняться: выполняется
выпускать: выпускает
высказать: высказать
высказывание: высказывание
выслать: выслать
высокий: высоких, высокая, высоким
высота: высоте
выстрел: выстрела
выходить: выходят
гадать: гадать
газета: газетой, газет
галочка: галочка
гаразды: гаразд
генеральный: генеральный
генерировать: генерируемый
геометрически: геометрически
гипотеза: гипотеза
главное: главное
главный: главной, главный, главную, главные
глаз: глаза
говорить: говорю, говоря, говорят, говорить
голицын: голицына
голова: голову, голове
голос: голос, голосов
голосование: голосованием, голосования, голосование
голосовать: голосовать, голосуют
гораздо: гораздо
город: города, городах, город
горшков: горшков
горячий: горячих
горячо: горячо
господин: господа, господину
готовый: готовых, готов, готовой, готовы
грамота: грамоту
грамотно: грамотно
григорий: григорий
грозить: грозит
громко: громко
группа: группу, группы, группами, группах
группыфорум: группыфорум
гугл: гугл, гугла, гугле
давать: дает, давать, давайте, даю
далее: д, далее
даниил: даниил
данные: данных, данным
данный: данный
дать: дать, дайте
двадцать: двадцати
дверь: двери
движок: движок
дебаг: дебаг
дебют: дебют
девушка: девушек
девяностый: девяностые
дежавю: дежавю
действие: действия, действий
делать: делать, делает, делал, делаете, делаю
деликатный: деликатное
дело: дело, деле, дела
демидов: демидову
денежка: денежка
денискин: денискин
день: дней
деньга: деньги
дерек: дерек
держатель: держателям
держать: держать
десятка: десятки
деталь: деталях, детали
децентрализованный: децентрализованной
дешёвый: дешевле, дешевого
деятельность: деятельностью, деятельности
джефф: джефф
джордж: джорджу
дзен: дзен
дизаблить: дизаблить
дизайнер: дизайнеры
директор: директор, директора
дискуссия: дискуссии
дмитрий: дмитрий
добавить: добавил, добавили, добавить
добавиться: добавился
добавление: добавления
добавляться: добавляться
добрый: доброй
договориться: договориться
доделать: доделаете
додумывать: додумывать
должный: должна, должен, должны
доля: доля
дом: дома
домен: домены, доменов
дон: дону
дора: доры
дорабатываться: дорабатываться
дорвей: дорвеями, дорвеи
дорвейный: дорвейного
дорвейщик: дорвейщиками, дорвейщики
дорого: дорого
достаточно: достаточно
доступ: доступа, доступе, доступ
доступный: доступной, доступных, доступны
дрогановый: дроганов
друг: друзьям, друг, друзьях, друга, друзья, друзьями, другом, друзей
другой: другого, другому, другим, другими
дружеский: дружеские
дубликат: дубликатами
дублироваться: дублируются
дубль: дубль
дубовик: дубовиков
думать: думаете, думаешь, думаю
евгений: евгений
евросеть: евросеть
единица: единицу
единственно: единственно
есть: ем
жаждать: жаждущие
жать: жмем
ждать: ждите, жду, ждать
желание: желание
желать: желающий, желающим
жертва: жертву
жест: жест
жизнеспособный: жизнеспособным
жизнь: жизнью
жительство: жительства
жить: живет
журналист: журналистов, журналистами
з: з
забанить: забанил
забанный: забанных
забыть: забыл, забудем
забыться: забылся
завал: завал, завале
завести: завести
зависеть: зависящим
зависимый: зависим
заворот: заворот
заговорить: заговорил
заголовок: заголовок, заголовком, заголовки
загрузить: загрузить
задавать: задаваемые
задать: задать
задаться: задался
задача: задача
задонатить: задонатить
задумать: задуманного
заинтересовать: заинтересовать
зайти: зашел, зайти
закинуть: закинула
закладка: закладки
заключать: заключает
заключаться: заключается
закрывать: закрывает
закрытый: закрыта, закрыт
заметный: заметным
замечательный: замечательное, замечательно
замысел: замыслу
занимать: занимают, занимает
занятие: занятия
занятный: занятный
занятой: занятые
записывать: записывать
запись: запись, записей, записи
запоздалый: запоздалые
запоститься: запостилось
запретить: запрещен
запрос: запросе, запросам, запросы
запускать: запускает
зарабатывать: зарабатывать
зарастать: зарастает
зарегистрироваться: зарегистрировался
засунуть: засунуть
затрагивать: затрагивающих, затрагивают
затрата: затраты
заходить: заходят
захотеть: захотел
захотеться: захотелось
зачётный: зачетному
заявить: заявили, заявленных
заявление: заявления
зваться: зовутся
здорово: здорово
здравствуйте: здравствуйте
злоумышленник: злоумышленники
знак: знак, знаком
знакомить: знакомящих
знакомый: знакомым, знакомых
знание: знаниям, знания
знать: знает, знают, знал, знаю, знаешь, знаем
значимость: значимость
значимый: значимой
значительный: значительное
зной: зной
зона: зон
зритель: зритель
ибо: ибо
иван: иван
иванов: иванов
игла: иглу
игнора: игнор
игорь: игорю
игра: игры
идеал: идеале
идеально: идеально
идеальный: идеальный, идеальную, идеальна
идея: идею, идеи, идеях, идея
идти: идет, идут, шла
избранный: избранные, избранных, избранное
известный: известные
издание: издание, изданиях
издеваться: издеваются
изменение: изменения
изменить: изменили, изменить
изменять: изменяющего
измерить: измерить
изначально: изначально
изнутри: изнутри
изображение: изображениям
изучать: изучают
иллюстрация: иллюстрация
имейл: имейл
иметь: имеет, имеющих
иметься: имеется, имеющихся
имхо: имхо
имя: имена
иначе: иначе
инбокс: инбокс
инвестиция: инвестиций
индиец: индийцев
индикатор: индикатор
иной: иного
инструмент: инструментами, инструмента, инструмент
интеграция: интеграции
интерактивный: интерактивное
интервью: интервью
интерес: интереса, интересов, интересам, интересы
интересно: интересно
интересный: интересны, интересную, интересна, интересным, интересный, интересные, интересного
интересовать: интересует
интересоваться: интересовался
интернет: интернета, интернете, интернет
интернетаальтернативный: интернетаальтернативная
интернетадзен: интернетадзен
интернетаформа: интернетаформа
инф: инфу
инфо: инфо
информация: информацию, информации, информация
иркутск: иркутск
искать: искать, искал, ищет
исключать: исключают
искусственно: искусственно
исполнительный: исполнительный, исполнительного
исполниться: исполнилось
использование: использование, использовании, использования
использовать: используют, использовать, использует, использованные, используя
использоваться: используется
исправить: исправите, исправить
исследование: исследование, исследованиями
история: истории
источник: источников, источник
исходить: исходя
исходный: исходным
итак: итак
июл: июл
июль: июля
июн: июн
июнь: июне
йорк: йорка
к: ко
каждый: каждой, каждого, каждом
казань: казань
какой: каких, каким, какому, какие, какую
календарь: календаря
калька: калька
камент: каментов, камента
камень: камней
кампания: кампания, кампании
камышева: камышев
капрановый: капранов
карибский: карибского
карма: карма, кармы, карму, карме, кармой
кармаграф: кармаграф
кармахабрахабра: кармахабрахабр
кармический: кармической
кармограф: кармографе
карта: карты, карта, карту
картина: картину
картинка: картинок, картинка
карьера: карьера
кастинг: кастинги, кастинга
катаклизм: катаклизм
каталог: каталогов
категория: категориям
кафе: кафе
качественный: качественный
качество: качества, качестве
киб: киб
кингдом: кингдом
кингдон: кингдон
кирилл: кирилл
клан: кланов
класс: класс
клик: клика, клики, клик
кликать: кликаешь, кликают, кликаю
кликнуть: кликнут, кликну
кликс: кликс
клинический: клинический
клип: клипы
клуб: клубов
ключевой: ключевых, ключевое
книга: книге
кнопка: кнопке, кнопки, кнопок, кнопка, кнопку
кнопочка: кнопочки
коварный: коварных
код: код, кодом
кой: коем
кол: кол
количество: количество, количеством, количестве, количества
коллажик: коллажик
коллега: коллеги, коллег, коллега
коллективный: коллективным, коллективного
колонка: колонок, колонках, колонки, колонке, колонку, колонка
команда: команда, команды
комби: комби
коментарий: коментариев, коментарий
комменарий: комменарий
коммент: коммента, комменты, комментов
комментариикодировкипочта: комментариикодировкипочта
комментарииулучшение: комментарииулучшения
комментарий: комментариям, комментариями, комментариев, комментарий, комментарии, комментариях, комментария, комментарию
комментировать: комментирует, комментировать
коммерц: коммерц
коммерциявладислав: коммерциявладислав
коммерцияинтернуть: коммерцияинтернет
коммуникация: коммуникация, коммуникаций
компания: компания, компании, компаний
комфортный: комфортные
комьюнити: комьюнити
конверт: конверта
конец: концу, конец, конца
конкретный: конкретному
конкурент: конкурентов
конкуренция: конкуренция
консалтинговый: консалтинговые
константин: константин
контекстный: контекстная, контекстной, контекстное
контент: контент, контента
контролироваться: контролируется
конференция: конференции
концепция: концепция, концепцию
концлагерь: концлагерях
копейка: копейки
копилка: копилку
копирайт: копирайте
копировать: копировать
корелировать: корелировать
корневой: корневой
короткий: короткий
корректор: корректором
корреспондент: корреспондент
костяк: костяк
который: которому, которое, которую, которым
кошкин: кошкин
коэффициент: коэффициент, коэффициентом
крайне: крайне
крайний: крайней
красивый: красивый, красивая
краснодар: краснодар
красноярск: красноярск
красный: красных
красота: красотой, красота, красоты
красотаплатежитрафикконтенттриз: красотаплатежитрафикконтенттриз
краткий: краткий, краткой, краткие
креатив: креативе
креативный: креативного
кредитный: кредитной
крейн: крейном, крейна
крестик: крестик
критерий: критерий
кровь: крови
крупный: крупных
круто: круто
крючков: крючков
кстати: кстати
ку: ку
куб: куб
кулина: кулин
культура: культуры
купить: купит
куча: кучи
кушнер: кушнеров
ладный: ладно
лазить: лазить
латиноамериканец: латиноамериканцы
лев: лев
легко: легко
лежать: лежала, лежит
лениво: лениво
леонид: леонид
либо: либо
лидерский: лидерские
лингвый: лингво
линк: линки
лист: лист
лицо: лицам
лично: лично
личный: личные
логика: логика
логин: логин, логине, логина
логично: логично
логичный: логичным
логотип: логотипом
любим: любим
любимый: любимый, любимых
любитель: любителей
любовь: любовь
любой: любом, любого, любому, любой
любопытство: любопытства
ля: ля
магазин: магазины, магазинов
магазинрун: магазинрун
май: мае
майами: майами
макинтош: макинтош
максим: максим
максимально: максимально
максимальный: максимальной
максимум: максимум
маленький: маленький, маленькое, маленьким, мал
малый: малая
маркет: маркете, маркет, маркета, маркетом
маркетинг: маркетинге, маркетингу, маркетинг, маркетинга
маркетинговый: маркетингового, маркетинговых
маркетолог: маркетологи
маскироваться: маскируясь
маслов: маслов
массовый: массовые, массовом
мастдать: мастдай
мастер: мастерам, мастера
мастерхост: мастерхост
материал: материал
мафиозный: мафиозных
мах: махом
машина: машин
мб: мб
мегабайт: мегабайты
мегабайтный: мегабайтная, мегабайтный
мегабеглый: мегабеглый
медиа: медиа
мейл: мейл
мелкий: мелкого
мелочь: мелочь
менеджер: менеджер
меню: меню
менять: меняют
мера: мере
мероприятие: мероприятие, мероприятиями
мертворождённый: мертворожденная
местный: местных, местном, местным
место: месте, места, местах, местам, место
месяц: месяц
метка: меток
метод: методы
мечта: мечта, мечты
мешать: мешают
миграция: миграции, миграция
микро: микро
микроформат: микроформаты, микроформату, микроформатами, микроформатах, микроформатов, микроформата, микроформатом
миллион: миллиона
мимикрия: мимикрии
мина: мин
минимум: минимум
минус: минус
минь: мини
мир: мире
мл: мл
мнение: мнения, мнение, мнению
многий: многим
многое: многое
многочислить: многочислены
множество: множество
модульность: модульность
мозг: мозг
мой: моей, моему, моих
молодой: молодыми
молодёжный: молодежной, молодежных
молчание: молчание
момент: момент, момента, моментом
монстр: монстр, монстров
море: моря
мотолог: мотолога
мочь: могу
мощный: мощного
мощь: мощи, мощь
мститель: мстителей
музыкальный: музыкальные
мутный: мутною
мыло: мыло
мысль: мысль, мысли
наблюдение: наблюдение
набор: набор
набрать: набрать
наверное: наверное
наверняка: наверняка
навигация: навигация
навсегда: навсегда
нагрузка: нагрузки
наделяев: наделяев
надеяться: надеется, надеюсь, надеяться
нажатие: нажатия, нажатии
нажать: нажав, нажал
найти: нашел, найдена, найти
наличие: наличие, наличия
намерить: намерена
наносить: наносят
написать: написать, написанную
напиток: напиток
наполнение: наполнение
напомнить: напомнило
направить: направлена, направлено
направление: направлении
направлять: направляющие
например: например
наравне: наравне
нарисовать: нарисовать
народ: народу
народный: народная, народных
население: населения
насколько: насколько
настоящий: настоящая, настоящее
настройка: настройка
наступить: наступил
настя: настя
наткнуться: наткнусь
натуральный: натуральных
наугад: наугад
находиться: находится, находимся
находка: находки
начало: начале
начать: начать
начинать: начинает, начинать
начинаться: начинается
начинающий: начинающие
наш: наших, нашем
небольшой: небольшую
невозможно: невозможно
негатив: негатива
неделя: неделе
недоделка: недоделок
недостаток: недостатки
недочетик: недочетик
недра: недрах
нежели: нежели
незаметно: незаметно
незамысловатый: незамысловатым
незнать: незнаю
неизбежный: неизбежном
неинтересный: неинтересно
некий: некая, некий, некую, некое, некой
некоторый: некоторые, некоторое
некрасиво: некрасиво
некролог: некрологов
некуда: некуда
немногое: немногим
необходимо: необходимо
необходимость: необходимость
необходимый: необходимое, необходимым
необязательно: необязательно
неограниченный: неограниченном
неожиданный: неожиданная
непонравиться: непонравившихся
непонятно: непонятно
непосвящённый: непосвященных
непривычно: непривычно
неприятный: неприятном
неработающий: неработающих
нереализуемый: нереализуема
несколько: нескольких, нескольку
несложный: несложные
несмотря: несмотря
несовершеннолетний: несовершеннолетних
несоизмеримый: несоизмеримо
нести: несут
нетов: нетов
нету: нету
неудобно: неудобно
неужели: неужели
неустранимый: неустранимая
неуютный: неуютно
неформальный: неформальную
нигде: нигде
нижний: нижний
никак: никак
никакой: никаких
никита: никите
никто: никто
нишевый: нишевого
новгород: новгород
новинка: новинки
новичок: новички
новость: новостях, новость, новости, новостей
новотёк: новотека
новый: новую, новые, новая, новый, новым, нового, новое, новых
нога: ногу
номер: номер, номера
носитель: носитель
нравиться: нравятся, нравится
нужный: нужный, нужен, нужной, нужна
нью: нью
о: обо
обеспечить: обеспечить, обеспечит
обещать: обещают, обещаю
обзор: обзор, обзорах, обзоры
обидеть: обидели
обкатать: обкатанной
облазить: облазил
облако: облако
область: область, области
обломать: обломать
обмен: обмен
обнаружить: обнаружил
обновить: обновить
обновляться: обновляется, обновляться
обозначение: обозначения
обрабатываться: обрабатывается
образ: образом, образ
образовательный: образовательная
обратить: обратили
обращаться: обращаюсь
обслуживание: обслуживания
обстоять: обстоят
обсудить: обсудить
обсуждать: обсуждали
обсуждение: обсуждение
общаться: общаться
общеизвестный: общеизвестны
общение: общения
общениеюзабилитихабрахабра: общениеюзабилитихабрахабр
общий: общем, общего
общность: общность
объединиться: объединились
объект: объекта
объём: объемы
обычный: обычного, обычным
обязательность: обязательность
ограниченный: ограниченной, ограниченную
ограничивать: ограничивает, ограничивать
огромный: огромная, огромными
один: одном, одно, одним, одну, одна, одному
одинаковый: одинаковым
одновременно: одновременно
однородный: однородного
оживить: оживить
ожидать: ожидать, ожидал
озадачить: озадачил
ознакомиться: ознакомиться
означать: означающая, означает
оказаться: оказалось
оказываться: оказывается
окно: окне
ом: ом
они: ним
онлайн: онлайн
онлайновый: онлайновые
оп: оп
оператор: оператор
операционный: операционными
опечатка: опечатки, опечаткам
описание: описания
описать: описать, опишете
описывать: описывать
оплата: оплатой, оплаты
оплачивать: оплачивать
оправдать: оправдала
определяться: определялось
оптимист: оптимиста, оптимист
опубликовать: опубликованные, опубликована
опускать: опускать
опустить: опустим
опыт: опыт
опытный: опытного
организация: организации
организовать: организовано, организовать
оружие: оружия, оружие
орфография: орфография
освоить: освоенных
основатель: основатель
основать: основанных
основное: основном
основной: основные, основной
основный: основных
осознавать: осознающие
осознание: осознании
осознать: осознал
оставить: оставив, оставленный
остальной: остальные, остальных, остальном
остаток: остаток
остаться: останется, останутся, оставшихся
осуществить: осуществить
отбивать: отбивающий
ответ: ответов, ответах, ответе, ответа, ответы, ответ
ответить: ответили, ответят, ответил, ответит
ответный: ответный, ответных
отвечать: отвечают, отвечать
отвратительный: отвратительного
отдавать: отдаваемых, отдаю
отдаваться: отдаваться
отдельный: отдельная, отдельное, отдельном
отдых: отдых
отечественный: отечественных
отзыв: отзывам
отклик: отклик
открытый: открытых, открытого, открытым
открыть: открыл, откроет
откуда: откуда
отличаться: отличаются, отличается
отличие: отличие
отлично: отлично
отменить: отменить
отметиться: отметившись
отнекиваться: отнекивался
относительный: относительная
относиться: относится
отношение: отношение, отношения
отображать: отображает
отображаться: отображались
отобрать: отобранных
отписаться: отписаться
отражаться: отражаются
отрицательный: отрицательная
отслеживать: отслеживает, отслеживать
отслеживаться: отслеживаются
отставать: отставать
отстраиваться: отстраиваться
отсутствие: отсутствие, отсутствия
отсутствовать: отсутствует, отсутствующих
отчаянно: отчаянно
отчёт: отчет
официальный: официальный
офлайн: оффлайн
офлайновый: оффлайновой
охота: охота
оценить: оценить
оценка: оценкой, оценки, оценка
очевидный: очевидным, очевидном
очередь: очередь
очетественный: очетественные
ошибаться: ошибаться
ошибиться: ошибусь
ошибка: ошибку, ошибки
ошибочно: ошибочно
ошибочный: ошибочных
ощущение: ощущения, ощущение
п: п
павел: павел
падать: падает
палец: пальцем
панелька: панелька
папка: папки
пара: паре, пару
параллельный: параллельные
париж: париж
пароль: пароля, пароль, пароли, паролей
партнёр: партнеров, партнеры
партнёрский: партнерский
партнёрство: партнерства
пассивный: пассивное
патайя: патайе
пенсионер: пенсионеров, пенсионеры
пенсия: пенсии
первый: первую, первых, первым, первое, первой, первые, первыми
переадресовать: переадресует
перевести: переведенные
перевод: переводы, перевод
переводить: переводить
переехать: переехать
перекодировка: перекодировки
перемещение: перемещение
переосмыслить: переосмысленное
переставать: перестает
переход: переходе
переходить: переходить
перечень: перечень
период: период
перл: перле
персональный: персональный
перспективный: перспективнейшим
петербург: петербурге
печатать: печатали
печатный: печатных
пиар: пиар
пиарить: пиарят
пингбек: пингбеки, пингбеков
пират: пиратов
писать: пишу, писать, пишите
письмо: письма
пихтый: пихто
пк: пк
план: планах, план
планета: планеты, планете
планировать: планируем
платить: платил
платный: платных
платёж: платежи
платёжный: платежного, платежную, платежных
плачевный: плачевный
плоскость: плоскость
плохо: плохо
плохой: хуже, плохой
площадка: площадки
плюс: плюса, плюс
победа: победе
победитель: победители, победителей
побочный: побочные, побочный
побродить: побродить
поведение: поведения
поверхность: поверхности
повод: поводу
повсеместный: повсеместного
повторить: повторить
повторять: повторяет, повторяю
повысить: повысить
подвести: подвел
подводный: подводных
поддержать: поддержать
поддержка: поддержка, поддержку
поделать: поделаешь
подкаст: подкастов, подкасты, подкаст
подкастер: подкастер
подкастинг: подкастинги, подкастинге
подкастинглюбимыерекомендацииобсуждениепредпочта: подкастинглюбимыерекомендацииобсуждениепредпочт
подкастобзоротчечественныйсписокстрельник: подкастобзоротчечественныйсписокстрельников
подключить: подключены
поднимать: поднимать
поднять: поднять
подняться: подняться
подобный: подобной, подобных, подобные
подписаться: подписаться
подписчик: подписчик
подписываться: подписываться
подразумевать: подразумевает
подробно: подробно
подробность: подробности
подростковый: подросткового
подросток: подростки
подручный: подручными
подсесть: подсели
подсила: подсилу
подслушивать: подслушивать
подсчёт: подсчете
подтверждать: подтверждает
подумать: подумают, подумать, подумал
подход: подходом, подход, подходы
подходить: подходит
подходящий: подходящий, подходящей
пожаловаться: пожаловалось
пожалуй: пожалуй
пожелание: пожелания
позволить: позволит
поздний: поздние
поздно: поздно
позиция: позиции
познакомиться: познакомились
позыв: позывам
поиск: поиска, поисках, поиск, поиску
поискгадань: поискгадани
поисковик: поисковиках, поисковиков
поисковый: поисковый, поисковых, поисковое
показать: покажет
показывать: показывать
покрывать: покрывающему
покупатель: покупателей
покупать: покупать
пол: полу
поле: полем, поле
полезный: полезна
полететь: полетят
поллучиться: поллучился
полный: полный, полную, полная, полного
положение: положения, положение
положительный: положительная
полочка: полочкам
получать: получаем, получает
получаться: получается
получение: получения
получить: получил, получить
получиться: получилось
пользователь: пользователь, пользователи, пользователе, пользователю, пользователя, пользователей
пользовательский: пользовательском, пользовательских, пользовательские
пользоваться: пользоваться, пользуются, пользуется
поменять: поменять
померкнуть: померк
поместить: помещу, поместить
пометить: помечена
пометка: пометки
помнить: помните
помогать: помогает
помочь: помочь
понажимать: понажимать
понимать: понимаю, понимает
понравиться: понравилось
понятие: понятий
понятно: понятно
понятный: понятные
понять: понял
поощрение: поощрение
поп: поп
попадать: попадаем, попадают, попадает
попадаться: попадается
попасть: попали, попасть
попробовать: попробовать, попробуйте
попугай: попугаи
популярность: популярность, популярности
популярный: популярного, популярные, популярным, популярными, популярных, популярен
попытка: попытки, попыток
пора: поры
порно: порно
порнография: порнографией
порядок: порядке
посему: посему
посетитель: посетителя
посещаемость: посещаемости
поскольку: поскольку
последний: последняя, последний, последним, последних
последующий: последующие
посмотреть: посмотреть, посмотрев
посредством: посредством
пост: постов, поста, посту, пост, посты
поставить: поставил
постоянно: постоянно
постоянный: постоянной
пострадать: пострадавших, пострадает
посыл: посыл
потенциал: потенциал
потечь: потекли
поток: потока, потоки
потратить: потратив, потратить
потребительский: потребительского
потребоваться: потребуется
поудалять: поудаляв
пофантазировать: пофантазировать
похожий: похожие, похожую
почитать: почитать
почта: почту, почте, почты, почтой
почувствовать: почувствовать
поэтому: поэтому
появиться: появилось
появляться: появляются
правило: правилам, правилах, правила
правильно: правильно
правильный: правильные, правильное
править: править
правозащитный: правозащитные
правый: правы
практика: практику
практически: практически
практический: практическом
превратить: превратит
предать: преданные
предлагать: предлагайте, предлагаю, предлагает
предлагаться: предлагаются, предлагается
предложение: предложения
предложениекомментарий: предложениекомментарии
предложениефункциональностьобщениеответный: предложениефункциональностьобщениеответные
предложить: предложить
предмет: предмет
предметный: предметной
предоставить: предоставить
предполагаться: предполагается, предполагалось
предпочитать: предпочитаете
предпочтение: предпочтений, предпочтение
предсказуемый: предсказуем
представитель: представители
представить: представить
представление: представления, представление
представлять: представляют, представляем
прелесть: прелестями
преподаватель: преподаватели
пресса: прессы
преступление: преступлений
приближаться: приближающихся
приблизительно: приблизительно
привезти: привезти
привет: привет
приветствовать: приветствую
привлекательность: привлекательность
привлекательный: привлекательные
привлекать: привлекает
привлечь: привлекла, привлечь
приводить: приводит
привычно: привычно
привычный: привычный
приглашение: приглашение
приготовиться: приготовьтесь
придерживаться: придерживаясь
придумать: придумал, придумали
призвать: призвано
признак: признаку, признаки
признательный: признателен
прийти: пришел, пришло
прийтись: прийдется
прикольно: прикольно
применение: применение, применения
применять: применять, применяемых
пример: примеров, примером, примере, примера, пример, примеры
примерно: примерно
примерный: примерная
принадлежать: принадлежит
принести: принести
принимать: принимать
принцип: принципа, принципу, принципе, принципы
принципиально: принципиально
принятие: принятие
природа: природе
присниться: приснилось
присоединиться: присоединиться
присутсвовать: присутсвуют
присутствие: присутствия
присутствовать: присутствует
присылать: присылаемый, присылать, присылает
приходить: приходят, приходить, приходит
приходиться: приходится
причина: причины, причин, причинам
причём: причем
проанализировать: проанализированные
проблема: проблем, проблемы, проблемой, проблема
пробовать: пробовали
провайдер: провайдеры, провайдера, провайдеров
провал: провал
проведение: проведение
проверить: проверить
провести: проведут, проведя, провели
проводиться: проводится
провоцировать: провоцирует
проглотить: проглотить
прогнозировать: прогнозирует
проголосовать: проголосуют
программа: программ, программой, программы
программирование: программировании
программка: программку
программный: программный
прогресс: прогресс
продажа: продаж, продажи, продажа, продаже
продвигать: продвигают, продвигать
продвижение: продвижения, продвижение
продвижениепартнерски: продвижениепартнерски
продукт: продукте
продюсер: продюсеры
проект: проекта, проекту, проект, проекты
произвести: произвела
производить: производят
происходить: происходит, происходило
пройти: пройдет, прошло
пролетариат: пролетариата
проливать: проливает
промоутировать: промоутируя
пропустить: пропустил, пропущенный
просить: прошу, просить
просмотр: просмотров, просмотра
просмотреть: просмотренной
простой: проста, прост, просты, простое, проще, простой, простые, простых
простота: простота
противный: противный
протокол: протоколом
профайл: профайла
профессионал: профессионалами, профессионалов
профессиональный: профессиональные
профиль: профиль, профиле
профит: профит
прочее: прочее
прочесть: прочесть
прочитать: прочитал, прочитав, прочитанного, прочитать
прочтение: прочтение
прошлый: прошлом
прощение: прощения
прямой: прямой
прятать: прятать
публикация: публикации
публиковать: публикую, публиковать
публичный: публичный
пук: пуках
пункт: пунктов
пуск: пуск
пускай: пускай
путаться: путаться
путешествовать: путешествуют
пытаться: пытаться
пытка: пытки
пятидневный: пятидневный
пять: пяти
работа: работа, работы
работат: работат
работать: работать, работающий, работающие, работает
равно: равно
рад: рад
радость: радость
развиватель: развиватель
развитие: развития
раздел: разделам, разделы, раздел, раздела, разделе
разлогинивание: разлогинивание
разложить: разложена
разместить: размещенных, разместить
разметить: размеченная, разметить
разметка: разметки
размещать: размещаю
размещаться: размещалась
размещение: размещение
разнести: разнесут
разный: разное, разного
разобраться: разберемся, разобраться
разослать: разослать
разрабатывать: разрабатываемые, разрабатывать
разработка: разработку, разработка, разработки
разработчик: разработчик
разрез: разрезе
разрешить: разрешен
разсылай: разсылая
разум: разуме
разумеется: разумеется
ракета: ракету
рамблер: рамблер
рамка: рамках
рамон: рамон
ранее: ранее
раскладывание: раскладыванию
распространение: распространение
распространить: распространенная
распространённость: распространенность
рассказ: рассказ
рассказать: расскажите, рассказать
рассматривать: рассматривать
рассматриваться: рассматривалась
рассмотрение: рассмотрения
рассмотреть: рассмотреть
рассчитать: рассчитать
расти: растет, растут
расхотеться: расхотелось
расцвет: расцвет
расценка: расценки
расчитываться: расчитывается
расчёт: расчет
расширить: расширен
реакция: реакции
реализовать: реализуема, реализовано, реализовать, реализована
реалить: реалити
реальный: реальный, реальные, реальных, реальной
ребята: ребят, ребята
ревить: ревью
революция: революцию
региональный: региональных, региональной, региональная
регистрация: регистрации
регулярный: регулярные
редактирование: редактирование, редактирования
редактировать: редактировать
редкий: редких
результат: результатом, результат, результатам
резюме: резюме
резюмирование: резюмирование
резюмировать: резюмирует
рейтинг: рейтингу, рейтингов, рейтингом, рейтинги, рейтинг
рейтингкармасбк: рейтингкармасбк
рейтинговый: рейтинговая
река: рекою
реклама: реклама, рекламе, рекламы, рекламой
рекламасетевой: рекламасетевой
рекламироваться: рекламироваться, рекламируемся
рекламист: рекламисты
рекламный: рекламная, рекламных, рекламную, рекламной
рекламодатель: рекламодателей, рекламодателями, рекламодатели
рекомендация: рекомендации
рекомендовать: рекомендуете, рекомендуем
реплика: реплики
ресторан: ресторанов
ресурс: ресурсы, ресурсов, ресурса
речь: речь
решать: решает
решаться: решался, решается
решение: решения, решение
решить: решили, решило, решил
рисовать: рисует
риф: риф
робот: робот, роботов
ровно: ровно
род: рода
ролик: ролику, ролики
роман: роман
росновский: росновский
российский: российский, российских
россия: россии
россомахина: россомахин
рост: роста, рост
ростов: ростов
рощупкина: рощупкин
ру: ру
рубрика: рубрики
рудняев: рудняев
рука: руках
румянцев: румянцев
рунет: рунете, рунета
рупоиск: рупоиска, рупоиск, рупоисков
русский: русском
русскоязычный: русскоязычной, русскоязычные
рыбак: рыбак
рыдать: рыдают
рынок: рынке, рынка
рэнс: рэнса
рядовой: рядового
сагалаев: сагалаев
сайт: сайт, сайта, сайте, сайтом, сайту, сайтов
сайтик: сайтик
салага: салага
самовыражение: самовыражения
самопроизвольно: самопроизвольно
самопроизвольный: самопроизвольное
самостоятельно: самостоятельно
самый: самое, самых, самые, самый, самым, самую
сбк: сбк
сбор: сбора
сборник: сборника
свежевыпечь: свежевыпеченной
сверхпопулярный: сверхпопулярный
свободный: свободном, свободный
свой: своим, своими, своем, свой
связанный: связанной
связать: связано
связь: связей, связь
сдавать: сдавать
сделать: сделаю, сделайте, сделаны, сделан, сделала, сделать, сделал
сегмент: сегменты, сегмент
сегодняшний: сегодняшний
сезонность: сезонность
семинар: семинар, семинара, семинарах, семинаров
семь: семи
семён: семенов
сен: сен
сентябрь: сентября, сентябре
сервер: сервера, сервер
сервис: сервисов, сервису, сервисы, сервис, сервиса
сергей: сергей, сергея
сериал: сериал, сериалов
серия: серии
серчинга: серчинг
серь: серь
серьёзный: серьезного, серьезный, серьезная
сетевой: сетевое, сетевой
сеть: сеть, сети, сетях, сетей, сетями
сигнал: сигнал
сидеть: сидят
сиквел: сиквела
сильно: сильно
симметричный: симметричного
система: систем, системы, система, систему, системах, системой, системами
скажем: скажем
сказать: сказанное, скажу, сказанного
скачать: скачанной, скачать, скачало, скачайте
склонность: склонность
скобка: скобках
скорее: скорее
скоро: скоро
скрин: скрин
скриншот: скриншот
скрупулёзно: скрупулезно
скрывать: скрывать
скрываться: скрывается
скучать: скучающий, скучающими
слева: слева
следствие: следствие
следующий: следующим, следующем, следующую, следующая
слезть: слезут
сливать: сливать, сливаю
слово: слово, словами, словах
сложно: сложно
сложность: сложность
случай: случай, случаях, случае
случайно: случайно
слушать: слушаем, слушал, слушать
слышать: слышал
смежный: смежным
смелый: смелый
смена: смене
смешной: смешным
смеяться: смейтесь
сми: сми
смирнов: смирнов
смит: смит
смотреть: смотрим, см, смотреть, смотря
смочь: сможем
смущать: смущают
смысл: смысл, смысла
смысловой: смысловой
сниться: снятся
снять: сняли
собираться: собирается, собираюсь, собирался
собрать: собрать
собраться: собрались
собственно: собственно
собственноручно: собственноручно
собственный: собственного, собственный, собственным, собственное
совершение: совершения
совершенно: совершенно
совет: совет
совместно: совместно
совпадать: совпадает
совпадение: совпадении
совпасть: совпали, совпадет
согласно: согласно
содержать: содержал
содержимое: содержимое
создавать: создавать, создавая, создают
создаваться: создаются, создавался
создание: создание, создания
создатель: создатели, создателя
создать: созданный, создать
созреть: созрела
сокура: сокур
сомнение: сомнения
сомнительно: сомнительно
сомнительный: сомнительной
сон: сны, сне, сон
сонприснилосьинтернетфриспич: сонприснилосьинтернетфриспич
сообразно: сообразно
сообщение: сообщений, сообщения, сообщение
сообществаинтернуть: сообществаинтернет
сообществасоциальныесетиюрист: сообществасоциальныесетиюристы
сообщество: сообщество, сообществ, сообщества
сообществосоциальныесетинишевойбренд: сообществосоциальныесетинишевойбренд
соответсвенный: соответсвенно
соответствовать: соответствующий
сопровождение: сопровождения
сортировать: сортировать
сортировка: сортировку
составление: составления
составлять: составляли, составляющая
составной: составных
состояние: состояние
состоять: состоят
сотня: сотни
сотрудник: сотрудники
софт: софт
социализироваться: социализирующиеся
социально: социально
социальный: социальной, социальных, социальными, социальная, социальную, социальные
социум: социум
спад: спада, спад
спам: спам
спец: спецам
специалист: специалистам, специалисты
специальный: специальные, специальная
специфичный: специфичных
список: списке, списку, список, списка
спонсор: спонсор
спорный: спорно
способ: способ, способом
справедливость: справедливость
справедливый: справедливым
спрашивать: спрашивать, спрашивал, спрашивайте
спросить: спросить, спросил
спрятаться: спрячешься
спустя: спустя
сравнение: сравнению
сравнить: сравнить
сразу: сразу
среди: среди
средний: средний
средство: средствами, средств, средство
ссср: ссср
ссылаться: ссылаться
ссылка: ссылками, ссылке, ссылка, ссылкой, ссылку, ссылки, ссылок
ставрополь: ставрополь
стагнация: стагнации
стадия: стадии
стандарт: стандартам
стандартный: стандартные
становиться: становились, становится
старгетировать: старгетированных
старикан: стариканов
старт: старт
старший: старше
старый: старые, старую, старой
статистика: статистика, статистики
статистический: статистическое
стать: стали, станет, статей, станут
статьимнениепубликация: статьимнениепубликации
статья: статьями, статью, статье, статья, статьи
стенание: стенаний
стих: стихов
стоить: стоит
столица: столиц
столько: столько
сторннний: сторннних
сторона: сторона, стороны
страна: странах
страница: странице, страниц, страницы, страницам, страница
странно: странно
странность: странности
странный: странных, странной, странное, странная
стратегически: стратегически
стратегия: стратегий
страшилка: страшилка
стрельников: стрельникова
стремиться: стремиться
строгий: строгих
строить: строить
строка: строке, строк
строчка: строчки
структура: структура
студия: студии
стёб: стеба
судить: судя
судьба: судьба
сумма: сумму
суммарный: суммарная
суровый: суровый
сутки: сутки
суть: сути
сухой: сухой
существенно: существенно
существовать: существуют, существует, существовала
существующий: существующего, существующих
сфера: сферу, сферам, сфере
сфокусировать: сфокусированное
схема: схеме, схему, схемы
считать: считают, считать, считает
считаться: считающийся
счёт: счета, счет
сша: сша
сычёв: сычев, сычева
сюда: сюда
сёрфер: серфер
таблица: таблицы, таблицу, таблицами
таг: таг, таги, тагами
таиланд: тайланда, тайланд
тайландобломрепортаж: тайландобломрепортаж
таки: таки
таковой: таковые, таковой
такой: таким, таком, такого, такую, таких, такому
талант: талантом
таргетирование: таргетирование
таргетированность: таргетированность
таргетировать: таргетировать, таргетированная
татьяна: татьяна
тачпад: тачпад
тв: тв
тег: теги, тег, тегов
тейлор: тейлор
текст: текстах, текста, тексты, текстов, текст, текстом
телевизионный: телевизионные
телефон: телефонов
телефония: телефонии
тело: теле
тема: тему, темы, теме, тема, темой
тематика: тематики
тематический: тематических
темп: темпами
тестирование: тестирования
техника: техники
технически: технически
технический: техническая, техническую
технология: технологиях, технологий, технологии, технология
течение: течение
тинэйджер: тинэйджерами
тип: типа
титов: титов
ткнуть: ткнуть
товарищ: товарищ, товарища
тонкость: тонкости
топ: топ
торговляэлектронный: торговляэлектронная
тот: той
точечный: точечной
точка: точек
точнее: точнее
точность: точностью
точный: точного
транслировать: транслировать
трансляция: трансляции
трафик: трафика, трафику, трафике, трафик
траффик: траффика
тред: треда, треде
трекбек: трекбеков, трекбеки
тренд: трендов, тренд, тренды, тренда
трендгорячиеточкирунетаактивныйростинтернуть: трендгорячиеточкирунетаактивныйростинтернет
трендсеттер: трендсеттеров
третий: третье, третьих
три: трем
тридцать: тридцати
триз: триз
тропа: тропа
трудно: трудно
трудность: трудностей
трудный: трудный
трёхмерный: трехмерная, трехмерных
тусовочный: тусовочными
тысяча: тысячи
тэг: тэгов, тэг, тэги
тяжёлый: тяжелым
тёмный: темной
убеждение: убеждению, убеждениям
убить: убей, убили
уважаемый: уважаемый
уведомление: уведомления, уведомлений
увеличиваться: увеличивается
увеличить: увеличить
уверенно: уверенно
уверенный: уверен
уверить: уверены
увидеть: увидел
удаление: удаление
удалить: удалить, удалена
удар: удар
удержание: удержания
удивительно: удивительно
удобно: удобно
удобный: удобные, удобнее, удобней
удовольствие: удовольствием
уезжать: уезжаю
ужастъ: ужастъ
ужесточать: ужесточает
узкий: узкая, узкой
узко: узко
узнавать: узнавать
узнать: узнать
указание: указанием
указать: указан, указать
указывать: указывает
укладываться: укладывается
украина: украины
улендеев: улендеева, улендеев
улендеевэффективностьтрафить: улендеевэффективностьтрафи
ульянов: ульянов
уменьшаться: уменьшается
уменьшить: уменьшить
уменьшиться: уменьшилась
уместный: уместней
уметь: умеем, умею
умничанье: умничанья
умно: умно
умный: умное
умудряться: умудряется
универсальный: универсального, универсальное
упаковка: упаковке
упорядочивание: упорядочиванию
управление: управления
ура: ура
усилить: усилят
условие: условии, условиях, условия
услуга: услуги
услышать: услышал, услышать
успеть: успел
успех: успех
успешно: успешно
успешный: успешной
уста: уст
установить: установить
устареть: устарела
устраивать: устраивают
уступать: уступает
утверждение: утверждение
утопичный: утопична
утро: утро
утяжеляться: утяжеляется
уфа: уфа
участвовать: участвуют, участвует
участие: участие, участия
участник: участником, участников
учитывать: учитывая
учитываться: учитываться, учитывается
учить: учить
файл: файлу, файлов
файлик: файлик
факт: факта, факт
фантазия: фантазий
фетишист: фетишистов
фид: фид, фидов
филипп: филипп
финансы: финансы
фича: фича
флеймера: флеймеры
фокусировка: фокусировки, фокусировок
форма: форма, форму, форме, формой
формат: формату, форматов
формирование: формирование
формировать: формировать
форум: форума
фото: фото
фотографировать: фотографировать
френд: френдами, френдов
функционал: функционала
функциональность: функциональность
функция: функция, функцию, функции, функцией
фёдор: федор
х: х
хаба: хабы
хабра: хабра, хабр, хабре
хабравойна: хабравойны
хабраперл: хабраперл
хабратред: хабратред, хабратреда
хабратредстартер: хабратредстартеру
хабрахабра: хабрахабре, хабрахабра, хабрахабр
хабрахабркомментарий: хабрахабркомментарии
хабрахабрконтекстный: хабрахабрконтекстная
хабрахаброшибкирейтинг: хабрахаброшибкирейтинг
хабрахаброшибкитег: хабрахаброшибкитеги
хабрахабрпоиск: хабрахабрпоиск
хабрахабррекомендациирейтингпредпочтение: хабрахабррекомендациирейтингпредпочтения
хабрахабртрекбекипингбек: хабрахабртрекбекипингбеки
хабрахабрхабратредпочта: хабрахабрхабратредпочта
хабриэлла: хабриэллы
хабриэль: хабриэлю
хабриэльхабриэлла: хабриэльхабриэлла
хакер: хакеров
характеризовать: характеризовать
хардинга: хардинг, хардинга
хватать: хватает
хм: хм
ход: ходе
холдинг: холдинга
хороший: хороших, лучшие, хорошая, хорошую, лучшей, хороший
хотеть: хочу, хочет, хотите, хотел
хотеться: хотелось, хочется
хотяб: хотябы
хранить: хранить
хуан: хуан
художник: художники
целевой: целевой, целевую
цель: цели, целей
цена: ценой
ценить: ценю
цент: цента
цеплять: цепляет
цитировать: цитировать
цифра: цифры, цифра
цифровой: цифрового
цнтить: цнти
чаво: чаво
час: час
частность: частности
частый: частые
часть: частей, части
чекбокс: чекбокс, чекбоксов
человек: людям, человека, людей, человеку
человеческий: человеческая
честно: честно
число: числе, числом
чистить: чистить
чисто: чисто
чистовый: чистов
чистый: чистых
читатель: читателям
читать: читать, читает, читают
чтение: чтения
чудо: чудес
чужой: чужих
чулан: чулан
чёткий: четкому
чётко: четко
шаг: шагом
шагать: шагали
шанс: шанс
шансс: шансс
шар: шар
шестой: шестое
широкий: широкое
широко: широко
шота: шот
шоу: шоу
шпионский: шпионское
штоль: штоли
штука: штуку, штука
шустрый: шустер
шутка: шутка
ы: ы
экологический: экологические
экс: экс
экскюзивный: экскюзивно
электронный: электронная, электронный
элемент: элементов
элитный: элитный
эмоциирезюмир: эмоциирезюмир
энергетический: энергетическим
эпизод: эпизод
эротика: эротике
эротический: эротическими, эротической
этический: этическая
эфтаназия: эфтаназии
эффект: эффект
эффективно: эффективно
эффективность: эффективность, эффективности
эффективный: эффективное, эффективной, эффективна
юзабельный: юзабельной
юзабилититэгиидеихабрахабра: юзабилититэгиидеихабрахабр
юзабилить: юзабилити
юзер: юзер, юзера, юзеры
юзибилистый: юзибилист
юзибилить: юзибилити
юноша: юношей
юридический: юридическая
юрий: юрий
юрист: юристов
явка: явки
являться: являющихся, является, являются
явно: явно
явный: явные
язык: языка, язык, языке
яндекс: яндексе, яндекс, яндекса
яндексрупоискблокнотиктрафикдорыоптимист: яндексрупоискблокнотиктрафикдорыоптимист
ящик: ящиков
